NO ./textures/north.xpm
SO ./textures/south.xpm
WE ./textures/west.xpm
EA ./textures/east.xpm
F 40,40,40
C 120,120,120

111111
100001
10N001
11111